mouse = fare
have a hold on something = bir şeyin bloke olması
to be broke = beş parasız olmak
the due date = bitiş tarihi
horrible = korkunç
lend = ödünç vermek
go out = biriyle çıkmak / dışarı çıkmak
get a bite to eat = bir şeyler atıştırmak
catch a movie = sinemaya gitmek (gayriresmi)
sound like = kulağa .. gibi gelmek
pick someone up = birini arabayla almak
have gotta do something = bir şey yapmak zorunda olmak
knock yourself out = keyfine bak
take your time = acele etme
call it a day = işi paydos etmek
What's got into you? = noldu la sana
make a move on someone = birine asılmak,yürümek
by the way = bu arada btw
properly = düzgün bir şekilde
get something shipped = göndermek
likely = muhtemelen,olası
unlikely = muhtemel değil, olası değil
get out of here = defol git
my head is killing me = aşırı derecede baş ağrım war
to be starving = aşırı acıkmak
don't get me wrong = beni yanlış anlama
what is with it? = onun derdi ne
fit in somewhere = bir yere uyum sağlamak
hometown = memleket
consider = düşünmek
commit = işlemek (suç vb)
approach (N) = bir konuya yaklaşım
approach (V) = yaklaşmak
cautious = temkinli,dikkatli
pratical = uygulamalı
concern = endişe
establish = kurmak (şirket vb)
intend = niyet etmek
intended = amaçlanan
tendency = eğilim
upward = yukarıya doğru
eventually = en sonunda
employment = istihdam
stimulate = uyarmak,canlandırmak
rural = kırsal
approve of = onaylamak
flat tyre = patlak teker
to be keen on = hevesli olmak
to be ashamed of = bir şeyden utanmak
particular = belirli
recall = hatırlamak
resist = direnmek
to be charged with = suçlanmak
spectecular = göz alıcı,muhteşem
appearance = görünüm
emphasize = vurgulamak
express = ifade etmek
cruel = acımazsız
deliberately = kasten
issue = mesele,konu,problem
controversial = tartışmalı
unfair = haksız,taraflı
suppose = sanmak,varsaymak
realize = farkına varmak
notice = dikkat etmek,dikkatini çekmek,fark etmek
doubt = şüphe
desire = arzulamak
in view of = -den ötürü,göz önüne katarak
reveal = ortaya çıkarmak
useful = faydalı
paperwork = evrak işi
significant = kayda değer
stock market = borsa
convenient = uygun,münasip
found = kurmak,tesis etmek
admire = taktir etmek
embrace = kucaklamak / bir şeyi kabullenmek
eagerly = heveslice
for instance = örnek olarak
inflected verb = çekimli fiil
pursue = peşine düşünmek
neutral = tarafsız
abandon = terk etmek
conduct = yönetmek, idare etmek
attitude = davranış
bent = kıvrılmış
trial = duruşma
court = mahkeme
examine = incelemek
evidence = kanıt
accordingly = buna göre
in vain = boşuna
relevant = konuyla ilgili,bağlantılı
irrevelant = alakasız
matter = konu, mesele
envy = imrenmek
blame = suçlamak
emberassing = utanç verici
admit = itiraf etmek
coast = sahil kıyısı
commission = komisyon
constitute = oluşturmak
strict = katı
appeal = çağrı
urgant = acil
range = menzil / aralık,civarında
extensive = geniş,yaygın
grant = onaylamak (resmi)
I am pleased = memnun oldum
inform = bilgilendirmek
entertain,amuse = eğlendirmek
convince,persuade = ikna etmek
innocence = masumiyet
earnest = ağırbaşlı
supply = sağlamak,tedarik etmek
wander = gezintiye çıkmak
insist = ısrar etmek
demand = talep etmek
confident = kendinden emin
inspire = ilham vermek
reflect = yansıtmak
owe = borçlu olmak
stunning = nefes kesici
committed = kendini adamış
claim = iddia etmek
to consist of = -den oluşmak
intimate = samimi / mahrem
novel = roman
compel = zorlamak (force)
venture = teşebbüs,riskli girişim
joint venture = ortak girişim
territory = alan, bölge
have a temper = sinirli, asabi olmak
undertake = bir işi üstlenmek
comprehensive = kapsamlı
majority = çoğu
give up = vazgeçmek / teslim olmak
take off = üstünü çıkarmak / uçağın kalkması
look up = sözlükte aramak
look for = aramak
stand up for = desteklemek, arka çıkmak
write down = not almak
carry on = devam etmek
interrupt = yarıda kesmek
stand out = dikkat çekmek / diğerlerine nazaran öne çıkmak
look forward to = dört gözle beklemek
run out = tükenmek
debate = tartışma, çekişme
restriction = kısıtlama
individuals = bireyler
imitate = taklit etmek
lead to = sebep olmak
dispute = anlaşmazlık
expression = ifade
get off = araçtan inmek 
refer to = kastetmek, anlamına gelmek
tension = gerginlik / tansiyon
numerous = çeşitli
respiratory system = solunum sistemi
circulatory system = dolaşım sistemi
digestive system = sindirim sistemi
excretory system = boşaltım sistemi
immune system = bağışıklık sistemi
nervous system = sinir sistemi
digest = sindirme
wide range of = geniş kapsamlı
influence = etki
obvious = bariz